orb of transmutation|진화의 오브
tainted orb of fusing|더럽혀진 연결의 오브
fracturing orb|분열의 오브
veiled orb|장막의 오브
grand eldritch ichor|우수한 섬뜩한 영액
engineer's shard|기술자의 파편
crusader's exalted orb|십자군의 엑잘티드 오브
maven's chisel of avarice|탐욕의 메이븐의 끌
wild crystallised lifeforce|야생 생기 결정
divine orb|신성한 오브
jeweller's orb|쥬얼러 오브
rogue's marker|도둑의 증표
lesser eldritch ichor|하급 섬뜩한 영액
eldritch exalted orb|섬뜩한 엑잘티드 오브
exalted orb|엑잘티드 오브
infused engineer's orb|주입된 기술자의 오브
maven's chisel of divination|점술의 메이븐의 끌
maven's chisel of proliferation|확산의 메이븐의 끌
orb of horizons|지평의 오브
exceptional eldritch ichor|특출난 섬뜩한 영액
gemcutter's prism|세공사의 프리즘
horizon shard|지평의 파편
maven's chisel of procurement|조달의 메이븐의 끌
portal scroll|포탈 주문서
vaal orb|바알 오브
hinekora's lock|히네코라의 머리카락
maven's chisel of scarabs|갑충석의 메이븐의 끌
chaos orb|카오스 오브
chromatic orb|색채의 오브
binding shard|속박의 파편
orb of alteration|변화의 오브
orb of dominance|지배의 오브
engineer's orb|기술자의 오브
tainted jeweller's orb|더럽혀진 쥬얼러 오브
tailoring orb|재단 오브
harbinger's orb|선구자의 오브
orb of conflict|갈등의 오브
redeemer's exalted orb|대속자의 엑잘티드 오브
orb of augmentation|확장의 오브
orb of annulment|소멸의 오브
fracturing shard|분열의 파편
blacksmith's whetstone|대장장이의 숫돌
ancient orb|고대의 오브
chaos shard|카오스 파편
eldritch orb of annulment|섬뜩한 소멸의 오브
mirror of kalandra|칼란드라의 거울
sacred crystallised lifeforce|신성한 생기 결정
orb of regret|후회의 오브
mirror shard|거울 파편
exceptional eldritch ember|특출난 섬뜩한 불씨
orb of binding|속박의 오브
lesser eldritch ember|하급 섬뜩한 불씨
regal orb|제왕의 오브
regal shard|제왕의 파편
enkindling orb|자극의 오브
glassblower's bauble|유리직공의 방울
eldritch chaos orb|섬뜩한 카오스 오브
scroll of wisdom|감정 주문서
hunter's exalted orb|사냥꾼의 엑잘티드 오브
orb of unmaking|취소의 오브
armourer's scrap|방어구 장인의 고철
awakener's orb|각성자의 오브
greater eldritch ember|상급 섬뜩한 불씨
tainted divine teardrop|더럽혀진 신성한 눈물방울
tainted mythic orb|더럽혀진 신화 오브
sacred orb|성스러운 오브
grand eldritch ember|우수한 섬뜩한 불씨
vivid crystallised lifeforce|혈기 생기 결정
warlord's exalted orb|전쟁군주의 엑잘티드 오브
orb of chance|기회의 오브
instilling orb|주입의 오브
ancient shard|고대의 파편
greater eldritch ichor|상급 섬뜩한 영액
blessed orb|축복의 오브
orb of fusing|연결의 오브
cartographer's chisel|지도제작자의 끌
veiled scarab|장막 갑충석
primal crystallised lifeforce|원시 생기 결정
tainted armourer's scrap|더럽혀진 방어구 장인의 고철
tainted chromatic orb|더럽혀진 색채의 오브
facetor's lens|무아지경의 렌즈
eternal orb|영원의 오브
tempering orb|단조 오브
exalted shard|엑잘티드 파편
tainted blacksmith's whetstone|더럽혀진 대장장이의 숫돌
annulment shard|소멸의 파편
stacked deck|카드 묶음
tainted chaos orb|더럽혀진 카오스 오브
tainted exalted orb|더럽혀진 엑잘티드 오브
reflecting mist|투영하는 안개
orb of alchemy|연금술의 오브
harbinger's shard|선구자의 파편
orb of scouring|정제의 오브
blessing of tul|툴의 축복
fragment of knowledge|지식의 조각
incursion scarab of timelines|시간선의 기습 갑충석
offering to the goddess|여신에게 바치는 공물
abyss scarab of profound depth|심원한 깊이의 심연 갑충석
scarab of radiant storms|찬란한 폭풍의 갑충석
forgotten reliquary key|잊혀진 성유물 보관실 열쇠
blight scarab of blooming|개화의 역병 갑충석
chayula's breachstone|차율라의 균열석
timeless vaal emblem|무궁한 바알 상징
essence scarab of stability|안정의 에센스 갑충석
titanic scarab of treasures|보물의 거대한 갑충석
scarab of stability|안정의 갑충석
fragment of purification|정화의 조각
timeless maraketh splinter|무궁한 마라케스 파편
harbinger scarab of obelisks|오벨리스크의 선구자 갑충석
ritual scarab of abundance|풍부함의 의식 갑충석
xoph's breachstone|조프의 균열석
torment scarab of peculiarity|기이함의 고통 갑충석
sacred blossom|신성한 꽃
horned scarab of awakening|각성의 뿔 달린 갑충석
fragment of shape|형성의 조각
veritania's crest|베리타니아의 문양
tribute to the goddess|여신에게 바치는 제물
anarchy scarab of gigantification|비대화의 혼란 갑충석
decaying reliquary key|부패하는 성유물 보관실 열쇠
essence scarab of calcification|석회화의 에센스 갑충석
sacrifice at dawn|새벽의 희생
beyond scarab of the invasion|침략의 이계 갑충석
sacrifice at midnight|심야의 희생
anarchy scarab|혼란 갑충석
legion scarab of command|지휘의 군단 갑충석
beyond scarab of haemophilia|혈우병의 이계 갑충석
timeless eternal empire splinter|무궁한 영원한 제국 파편
sulphite scarab of greed|탐욕의 아황산염 갑충석
visceral reliquary key|본능적인 성유물 보관실 열쇠
unrelenting timeless eternal emblem|가차없는 무궁한 영원의 상징
horned scarab of glittering|번쩍임의 뿔 달린 갑충석
legion scarab of eternal conflict|영원한 분쟁의 군단 갑충석
titanic scarab of legend|전설의 거대한 갑충석
tul's flawless breachstone|툴의 결함 없는 균열석
blazing fragment|불길의 조각
essence scarab|에센스 갑충석
fragment of the chimera|키메라의 지도 조각
ancient reliquary key|고대의 성유물 보관실 열쇠
fragment of emptiness|허무의 조각
harbinger scarab of regency|섭정의 선구자 갑충석
timeless karui splinter|무궁한 카루이 파편
cosmic fragment|별나라의 조각
ultimatum scarab of bribing|매수의 결전 갑충석
domination scarab of evolution|진화의 지배 갑충석
writhing invitation|꿈틀거리는 초대
beauty|아름다움
sacrifice at dusk|황혼의 희생
an audience with the king|왕 알현
horned scarab of bloodlines|혈맹의 뿔 달린 갑충석
betrayal scarab of intelligence|지능의 배신 갑충석
tul's breachstone|툴의 균열석
breach scarab of lordship|지위의 균열 갑충석
timeless maraketh emblem|무궁한 마라케스 상징
ambition|야심
breach scarab of snares|올가미의 균열 갑충석
oubliette reliquary key|지하 감옥 성유물 보관실 열쇠
shiny reliquary key|반짝이는 성유물 보관실 열쇠
delirium scarab of mania|광증의 환영 갑충석
ambush scarab of hidden compartments|비밀 공간의 매복 갑충석
betrayal scarab of perpetuation|영속화의 배신 갑충석
timeworn reliquary key|오래된 성유물 보관실 열쇠
ultimatum scarab|결전 갑충석
divination scarab of plenty|풍부함의 점술 갑충석
baran's crest|바란의 문양
torment scarab of release|해방의 고통 갑충석
awakening fragment|각성의 조각
abyss scarab of multitudes|군중의 심연 갑충석
expedition scarab of archaeology|고고학의 탐험 갑충석
splinter of xoph|조프의 파편
delirium scarab of paranoia|편집증의 환영 갑충석
simulacrum|복제된 영토
breach scarab|균열 갑충석
fragment of eradication|박멸의 조각
esh's breachstone|에쉬의 균열석
scarab of monstrous lineage|기괴한 혈통의 갑충석
timeless templar emblem|무궁한 템플러 상징
harbinger scarab|선구자 갑충석
breach scarab of splintering|파편의 균열 갑충석
sacrifice set|희생 세트
expedition scarab of the skald|시인의 탐험 갑충석
incursion scarab of invasion|침략의 기습 갑충석
timeless eternal emblem|무궁한 영원의 상징
gift to the goddess|여신에게 바치는 선물
incursion scarab|기습 갑충석
scarab of wisps|도깨비불의 갑충석
expedition scarab of runefinding|룬 탐색의 탐험 갑충석
blight scarab|역병 갑충석
beyond scarab|이계 갑충석
maddening object|광기의 물품
timeless templar splinter|무궁한 템플러 파편
key to the crucible|시련의 열쇠
horned scarab of nemeses|천벌의 뿔 달린 갑충석
mortal hope|필멸의 희망
scarab of divinity|신성의 갑충석
anarchy scarab of partnership|협력의 혼란 갑충석
blight scarab of bounty|하사품의 역병 갑충석
influencing scarab of the elder|엘더의 영향력 갑충석
splinter of chayula|차율라의 파편
fragment of the hydra|히드라의 지도 조각
legion scarab|군단 갑충석
al-hezmin's crest|알-헤즈민의 문양
mortal ignorance|필멸의 무지
crest of the elderslayers|엘더슬레이어의 문양
sulphite scarab|아황산염 갑충석
divination scarab of pilfering|훔쳐냄의 점술 갑충석
scarab of hunted traitors|쫓기는 배신자의 갑충석
key to decay|부패의 열쇠
timeless vaal splinter|무궁한 바알 파편
devouring fragment|포식의 조각
harvest scarab|수확 갑충석
cooperation|협력
breach scarab of resonant cascade|공명하는 폭포의 균열 갑충석
unrelenting timeless maraketh emblem|가차없는 무궁한 마라케스 상징
drox's crest|드록스의 문양
blessing of uul-netol|울네톨의 축복
influencing scarab of hordes|군단의 영향력 갑충석
breach scarab of the dreamer|몽상가의 균열 갑충석
abyss scarab of emptiness|허무의 심연 갑충석
valdo's puzzle box|발도의 퍼즐 상자
abyss scarab|심연 갑충석
unrelenting timeless vaal emblem|가차없는 무궁한 바알 상징
mortal set|필멸 세트
splinter of uul-netol|울네톨의 파편
chayula's flawless breachstone|차율라의 결함 없는 균열석
beyond scarab of corruption|타락의 이계 갑충석
archive reliquary key|서고 성유물 보관실 열쇠
influencing scarab of the shaper|쉐이퍼의 영향력 갑충석
ritual scarab of selectiveness|선택의 의식 갑충석
legion scarab of the sekhema|세케마의 군단 갑충석
dedication to the goddess|여신에게 바치는 헌신
sacrifice at noon|정오의 희생
ritual scarab of wisps|도깨비불의 의식 갑충석
unrelenting timeless templar emblem|가차없는 무궁한 템플러 상징
polaric invitation|극성의 초대
horned scarab of tradition|전통의 뿔 달린 갑충석
screaming invitation|절규하는 초대
cartography scarab of risk|위험의 지도 제작 갑충석
abyss scarab of edifice|건축물의 심연 갑충석
fragment of terror|공포의 조각
harvest scarab of cornucopia|풍요의 뿔의 수확 갑충석
cartography scarab of the multitude|군중의 지도 제작 갑충석
torment scarab|고통 갑충석
vaal reliquary key|바알 성유물 보관실 열쇠
unrelenting timeless karui emblem|가차없는 무궁한 카루이 상징
mortal grief|필멸의 슬픔
splinter of tul|툴의 파편
ultimatum scarab of inscription|새김의 결전 갑충석
mortal rage|필멸의 격노
simulacrum splinter|복제된 영토 파편
divine vessel|성스러운 시험관
fragment of constriction|위압의 조각
blessing of chayula|차율라의 축복
harvest scarab of doubling|복제의 수확 갑충석
crescent splinter|초승달 파편
decaying fragment|쇠퇴의 조각
fragment of the minotaur|미노타우로스의 지도 조각
titanic scarab|거대한 갑충석
splinter of esh|에쉬의 파편
bestiary scarab of the herd|떼의 야수 도감 갑충석
ambush scarab of discernment|분별의 매복 갑충석
horned scarab of pandemonium|혼란 유발의 뿔 달린 갑충석
divination scarab of the cloister|회랑의 점술 갑충석
cosmic reliquary key|우주의 성유물 보관실 열쇠
bestiary scarab of duplicating|복제의 야수 도감 갑충석
torment scarab of possession|사로잡힘의 고통 갑충석
bestiary scarab|야수 도감 갑충석
reality fragment|현실의 조각
horned scarab of preservation|보전의 뿔 달린 갑충석
delirium scarab of neuroses|신경증의 환영 갑충석
xoph's flawless breachstone|조프의 결함 없는 균열석
beyond scarab of resurgence|재기의 이계 갑충석
curiosity|호기심
blight scarab of the blightheart|메마른 심장의 역병 갑충석
legion scarab of officers|장교의 군단 갑충석
the maven's writ|메이븐의 문서
delirium scarab|환영 갑충석
ambush scarab of potency|잠재력의 매복 갑충석
betrayal scarab of reinforcements|보강의 배신 갑충석
scarab of bisection|양단의 갑충석
cartography scarab of escalation|증대의 지도 제작 갑충석
domination scarab of apparitions|유령의 지배 갑충석
voidborn reliquary key|공허의 시초 성유물 보관실 열쇠
domination scarab|지배 갑충석
synthesising fragment|결합의 조각
essence scarab of adaptation|적응의 에센스 갑충석
ultimatum scarab of catalysing|기폭의 결전 갑충석
incandescent invitation|백열하는 초대
delirium scarab of delusions|망상의 환영 갑충석
incursion scarab of champions|용사의 기습 갑충석
ritual vessel|의식의 그릇
fragment of enslavement|조종의 조각
ambush scarab|매복 갑충석
scarab of adversaries|적수의 갑충석
essence scarab of ascent|상승의 에센스 갑충석
cartography scarab of singularity|특이점의 지도 제작 갑충석
ultimatum scarab of dueling|결투의 결전 갑충석
domination scarab of terrors|공포의 지배 갑충석
expedition scarab|탐험 갑충석
bestiary scarab of the shadowed crow|그늘진 까마귀의 야수 도감 갑충석
ambush scarab of containment|봉쇄의 매복 갑충석
uul-netol's flawless breachstone|울네톨의 결함 없는 균열석
timeless karui emblem|무궁한 카루이 상징
blight scarab of invigoration|고무의 역병 갑충석
betrayal scarab|배신 갑충석
expedition scarab of verisium powder|베리시움 화약의 탐험 갑충석
fragment of the phoenix|불사조의 지도 조각
cartography scarab of corruption|타락의 지도 제작 갑충석
sulphite scarab of fumes|연기의 아황산염 갑충석
blessing of esh|에쉬의 축복
esh's flawless breachstone|에쉬의 결함 없는 균열석
uul-netol's breachstone|울네톨의 균열석
ritual splinter|의식의 파편
harbinger scarab of warhoards|전쟁비축물의 선구자 갑충석
blessing of xoph|조프의 축복
influencing scarab of conversion|전향의 영향력 갑충석
time rune|시간 룬
life rune|생명 룬
power rune|권능 룬
journey rune|여정 룬
bounty rune|하사품 룬
river rune|강 룬
mountain rune|산 룬
bound rune|속박 룬
sun rune|태양 룬
war rune|전쟁 룬
tattoo of the kitava heart eater|키타바 심장 포식자의 문신
tattoo of the ramako archer|라마코 궁수의 문신
omen of death-dancing|죽음의 춤의 징조
journey tattoo of the soul|영혼의 여정 문신
tattoo of the tawhoa naturalist|타호아 박물학자의 문신
tattoo of the arohongui moonwarden|아로호누이 달의 간수의 문신
tattoo of the tawhoa shaman|타호아 주술사의 문신
tattoo of the arohongui warrior|아로호누이 전사의 문신
omen of amelioration|개량의 징조
tattoo of the ramako sniper|라마코 저격수의 문신
tattoo of the hinekora shaman|히네코라 주술사의 문신
tattoo of the hinekora deathwarden|히네코라 죽음의 간수의 문신
tattoo of the kitava blood drinker|키타바 피 흡수자의 문신
tattoo of the tasalio tideshifter|타살리오 파도변화술사의 문신
tattoo of the tasalio warrior|타살리오 전사의 문신
tattoo of the valako shieldbearer|발라코 방패 운반자의 문신
tattoo of the tawhoa herbalist|타호아 약초상의 문신
tattoo of the hinekora warmonger|히네코라 전쟁광의 문신
tattoo of the hinekora storyteller|히네코라 이야기꾼의 문신
journey tattoo of the mind|정신의 여정 문신
tattoo of the valako warrior|발라코 전사의 문신
omen of blanching|표백의 징조
tattoo of the arohongui scout|아로호누이 정찰병의 문신
tattoo of the tawhoa warrior|타호아 전사의 문신
tattoo of the ngamahu warrior|나마후 전사의 문신
omen of adrenaline|아드레날린의 징조
omen of the soul devourer|영혼 포식자의 징조
tattoo of the tukohama warmonger|투코하마 전쟁광의 문신
tattoo of the tasalio scout|타살리오 정찰병의 문신
tattoo of the ramako fleetfoot|라마코 쾌속병의 문신
tattoo of the rongokurai guard|롱고쿠라이 수호병의 문신
tattoo of the ngamahu woodcarver|나마후 목각사의 문신
omen of connections|연결의 징조
tattoo of the tukohama shaman|투코하마 주술사의 문신
omen of death's door|죽음의 문턱의 징조
omen of return|귀환의 징조
tattoo of the rongokurai warrior|롱고쿠라이 전사의 문신
tattoo of the kitava shaman|키타바 주술사의 문신
tattoo of the rongokurai brute|롱고쿠라이 돌격병의 문신
tattoo of the tawhoa scout|타호아 정찰병의 문신
tattoo of the tasalio shaman|타살리오 주술사의 문신
omen of fortune|행운의 징조
tattoo of the valako scout|발라코 정찰병의 문신
tattoo of the tukohama brawler|투코하마 싸움꾼의 문신
tattoo of the kitava warrior|키타바 전사의 문신
journey tattoo of the body|육신의 여정 문신
tattoo of the valako stormrider|발라코 태풍의 기수의 문신
tattoo of the kitava rebel|키타바 반란자의 문신
tattoo of the arohongui warmonger|아로호누이 전쟁광의 문신
tattoo of the tukohama warcaller|투코하마 전쟁 소집자의 문신
tattoo of the ngamahu firewalker|나마후 화염보행자의 문신
tattoo of the valako shaman|발라코 주술사의 문신
tattoo of the hinekora warrior|히네코라 전사의 문신
tattoo of the ramako scout|라마코 정찰병의 문신
omen of brilliance|광채의 징조
tattoo of the tukohama warrior|투코하마 전사의 문신
tattoo of the rongokurai goliath|롱고쿠라이 골리앗의 문신
tattoo of the ngamahu shaman|나마후 주술사의 문신
tattoo of the arohongui shaman|아로호누이 주술사의 문신
tattoo of the rongokurai turtle|롱고쿠라이 거북이의 문신
omen of the jeweller|보석상의 징조
omen of refreshment|원기 회복의 징조
tattoo of the ramako shaman|라마코 주술사의 문신
tattoo of the tasalio bladedancer|타살리오 검의 무희의 문신
tattoo of the ngamahu warmonger|나마후 전쟁광의 문신
forbidden tome (level 69)|금지된 책 (69레벨)
forbidden tome (level 68)|금지된 책 (68레벨)
the second sacrament|두 번째 성체
the power and the promise|힘과 약속
the gilded chalice|도금된 성배
the blood of innocence|이노센스의 피
forbidden tome (level 80)|금지된 책 (80레벨)
forbidden tome (level 83)|금지된 책 (83레벨)
the chains of castigation|징계의 사슬
the hour of divinity|신성의 시간
forbidden tome (level 81)|금지된 책 (81레벨)
forbidden tome (level 82)|금지된 책 (82레벨)
forbidden tome (level 78)|금지된 책 (78레벨)
forbidden tome (level 79)|금지된 책 (79레벨)
the broken censer|부서진 향로
the first crest|최초의 문양
the night lamp|밤의 등화
the original scripture|원형의 성서
forbidden tome (level 72)|금지된 책 (72레벨)
forbidden tome (level 73)|금지된 책 (73레벨)
forbidden tome (level 70)|금지된 책 (70레벨)
forbidden tome (level 71)|금지된 책 (71레벨)
forbidden tome (level 76)|금지된 책 (76레벨)
forbidden tome (level 77)|금지된 책 (77레벨)
forbidden tome (level 74)|금지된 책 (74레벨)
forbidden tome (level 75)|금지된 책 (75레벨)
kirac's memory of survivor's guilt|키락의 기억 - 생존자의 죄책감
alva's memory of cascading fortunes|알바의 기억 - 쏟아지는 보물
niko's memory of demonic onslaught|니코의 기억 - 악마의 맹공
kirac's memory of phaaryl|키락의 기억 - 파아릴
kirac's memory of the pantheon|키락의 기억 - 판테온
einhar's memory of harvest beasts|아인하르의 기억 - 수확 야수
einhar's memory of crystal prisons|아인하르의 기억 - 수정 수용소
niko's memory of chasms|니코의 기억 - 절벽길
alva's memory of reverse incursion|알바의 기억 - 역기습
niko's memory of tormented souls|니코의 기억 - 고통받는 영혼
niko's memory of grasping hands|니코의 기억 - 거머쥐는 손
einhar's memory of the sacred grove|아인하르의 기억 - 신성한 숲
influenced scouting report|영향을 받은 정찰 보고서
delirious scouting report|환영의 정찰 보고서
blighted scouting report|역병 걸린 정찰 보고서
otherworldly scouting report|신기한 정찰 보고서
singular scouting report|비범한 정찰 보고서
explorer's scouting report|탐험가의 정찰 보고서
operative's scouting report|첩보원의 정찰 보고서
vaal scouting report|바알 정찰 보고서
comprehensive scouting report|상세한 정찰 보고서
perception contract (level 78-82)|통찰력 계약 (레벨 78-82)
demolition contract (level 73-77)|파괴 공작 계약 (레벨 73-77)
blueprint (level 78-82)|도면 (레벨 78-82)
lockpicking contract (level 73-77)|자물쇠 따기 계약 (레벨 73-77)
agility contract (level 73-77)|민첩함 계약 (레벨 73-77)
brute force contract (level 78-82)|완력 계약 (레벨 78-82)
deception contract (level 73-77)|기만 계약 (레벨 73-77)
blueprint (level 83+, 4 wings)|도면 (레벨 83 이상, 부속 건물 4개)
lockpicking contract (level 83+)|자물쇠 따기 계약 (레벨 83 이상)
agility contract (level 78-82)|민첩함 계약 (레벨 78-82)
demolition contract (level 68-72)|파괴 공작 계약 (레벨 68-72)
perception contract (level 68-72)|통찰력 계약 (레벨 68-72)
demolition contract (level 83+)|파괴 공작 계약 (레벨 83 이상)
lockpicking contract (level 78-82)|자물쇠 따기 계약 (레벨 78-82)
lockpicking contract (level 68-72)|자물쇠 따기 계약 (레벨 68-72)
perception contract (level 83+)|통찰력 계약 (레벨 83 이상)
engineering contract (level 78-82)|공학 계약 (레벨 78-82)
deception contract (level 78-82)|기만 계약 (레벨 78-82)
low-tier contracts|낮은 등급 계약
mid-tier contracts|중간 등급 계약
high-tier contracts|높은 등급 계약
top-tier contracts|최고 등급 계약
blueprints|도면
trap disarmament contract (level 78-82)|덫 해제 계약 (레벨 78-82)
blueprint (level 73-77)|도면 (레벨 73-77)
engineering contract (level 73-77)|공학 계약 (레벨 73-77)
perception contract (level 73-77)|통찰력 계약 (레벨 73-77)
counter-thaumaturgy contract (level 73-77)|반-마석학 계약 (레벨 73-77)
brute force contract (level 73-77)|완력 계약 (레벨 73-77)
blueprint (level 83+, 3 wings)|도면 (레벨 83 이상, 부속 건물 3개)
trap disarmament contract (level 68-72)|덫 해제 계약 (레벨 68-72)
trap disarmament contract (level 83+)|덫 해제 계약 (레벨 83 이상)
agility contract (level 83+)|민첩함 계약 (레벨 83 이상)
trap disarmament contract (level 73-77)|덫 해제 계약 (레벨 73-77)
engineering contract (level 83+)|공학 계약 (레벨 83 이상)
deception contract (level 83+)|기만 계약 (레벨 83 이상)
agility contract (level 68-72)|민첩함 계약 (레벨 68-72)
counter-thaumaturgy contract (level 68-72)|반-마석학 계약 (레벨 68-72)
brute force contract (level 68-72)|완력 계약 (레벨 68-72)
counter-thaumaturgy contract (level 83+)|반-마석학 계약 (레벨 83 이상)
brute force contract (level 83+)|완력 계약 (레벨 83 이상)
blueprint (level 68-72)|도면 (레벨 68-72)
demolition contract (level 78-82)|파괴 공작 계약 (레벨 78-82)
engineering contract (level 68-72)|공학 계약 (레벨 68-72)
deception contract (level 68-72)|기만 계약 (레벨 68-72)
blueprint (level 83+)|도면 (레벨 83 이상)
counter-thaumaturgy contract (level 78-82)|반-마석학 계약 (레벨 78-82)
scrap metal|고철
burial medallion|매장용 메달리온
exotic coinage|특이한 주화
astragali|복사뼈
whispering delirium orb|속삭이는 환영의 오브
delirium orb|환영의 오브
fine delirium orb|양질의 환영의 오브
thaumaturge's delirium orb|마석학자의 환영의 오브
blighted delirium orb|역병 걸린 환영의 오브
armoursmith's delirium orb|갑옷제작자의 환영의 오브
obscured delirium orb|가려진 환영의 오브
abyssal delirium orb|심연의 환영의 오브
jeweller's delirium orb|쥬얼러 환영의 오브
skittering delirium orb|달리는 환영의 오브
cartographer's delirium orb|지도제작자의 환영의 오브
foreboding delirium orb|불길한 환영의 오브
singular delirium orb|비범한 환영의 오브
blacksmith's delirium orb|대장장이의 환영의 오브
challenging delirium orb|도전하는 환영의 오브
fossilised delirium orb|화석화된 환영의 오브
fragmented delirium orb|조각난 환영의 오브
primal delirium orb|원시 환영의 오브
kalguuran delirium orb|칼구르 환영의 오브
diviner's delirium orb|예언자의 환영의 오브
timeless delirium orb|무궁한 환영의 오브
prismatic catalyst|분광의 기폭제
tempering catalyst|완화의 기폭제
unstable catalyst|불안정한 기폭제
abrasive catalyst|연마의 기폭제
imbued catalyst|부여의 기폭제
noxious catalyst|유독성 기폭제
turbulent catalyst|격동의 기폭제
intrinsic catalyst|본질의 기폭제
tainted catalyst|더럽혀진 기폭제
fertile catalyst|풍요의 기폭제
accelerating catalyst|가속의 기폭제
reflective oil|투영 성유
prismatic oil|분광 성유
violet oil|보랏빛 성유
golden oil|금빛 성유
teal oil|청록빛 성유
tainted oil|더럽혀진 성유
amber oil|호박빛 성유
opalescent oil|오팔빛 성유
azure oil|담청빛 성유
silver oil|은빛 성유
black oil|검은빛 성유
sepia oil|적갈빛 성유
crimson oil|진홍빛 성유
verdant oil|신록빛 성유
oil extractor|성유 추출기
indigo oil|남색 성유
clear oil|투명한 성유
thaumaturge's incubator|마석학자의 인큐베이터
geomancer's incubator|대지술사의 인큐베이터
fine incubator|양질의 인큐베이터
whispering incubator|속삭이는 인큐베이터
blighted incubator|역병 걸린 인큐베이터
celestial jeweller's incubator|천공의 보석상의 인큐베이터
celestial blacksmith's incubator|천공의 대장장이의 인큐베이터
abyssal incubator|심연의 인큐베이터
time-lost incubator|오래된 인큐베이터
diviner's incubator|예언자의 인큐베이터
mysterious incubator|수수께끼의 인큐베이터
primal incubator|원시 인큐베이터
obscured incubator|가려진 인큐베이터
challenging incubator|도전하는 인큐베이터
fossilised incubator|화석화된 인큐베이터
fragmented incubator|조각난 인큐베이터
eldritch incubator|섬뜩한 인큐베이터
skittering incubator|달리는 인큐베이터
maddening incubator|광기의 인큐베이터
ornate incubator|화려한 인큐베이터
kalguuran incubator|칼구르 인큐베이터
celestial armoursmith's incubator|천공의 갑옷제작자의 인큐베이터
otherworldly incubator|이계의 인큐베이터
cartographer's incubator|지도제작자의 인큐베이터
foreboding incubator|불길한 인큐베이터
gemcutter's incubator|세공사의 인큐베이터
enchanted incubator|인챈트된 인큐베이터
singular incubator|비범한 인큐베이터
infused incubator|주입된 인큐베이터
feral incubator|야생의 인큐베이터
prismatic fossil|분광 화석
hollow fossil|공허의 화석
lucent fossil|빛나는 화석
pristine fossil|온전한 화석
bound fossil|속박의 화석
opulent fossil|호화로운 화석
bloodstained fossil|피얼룩 화석
shuddering fossil|전율의 화석
serrated fossil|톱니 화석
aberrant fossil|특이한 화석
frigid fossil|차디찬 화석
aetheric fossil|에테르 화석
dense fossil|조밀한 화석
faceted fossil|연마한 화석
primitive chaotic resonator|초기형 혼돈 공명기
powerful chaotic resonator|강력 혼돈 공명기
metallic fossil|금속성 화석
jagged fossil|뾰족한 화석
prime chaotic resonator|최종형 혼돈 공명기
gilded fossil|도금된 화석
glyphic fossil|상형 문자 화석
potent chaotic resonator|강화형 혼돈 공명기
tangled fossil|얽혀든 화석
fundamental fossil|근본적인 화석
scorched fossil|그을린 화석
sanctified fossil|축성된 화석
fractured fossil|분열된 화석
corroded fossil|부식된 화석
deft fossil|날렵한 화석
shrieking essence of greed|악을 쓰는 탐욕의 에센스
deafening essence of contempt|귀를 찢는 경멸의 에센스
shrieking essence of anguish|악을 쓰는 비통의 에센스
deafening essence of zeal|귀를 찢는 열의의 에센스
shrieking essence of loathing|악을 쓰는 혐오의 에센스
wailing essence of zeal|울부짖는 열의의 에센스
wailing essence of greed|울부짖는 탐욕의 에센스
wailing essence of wrath|울부짖는 진노의 에센스
screaming essence of scorn|절규하는 멸시의 에센스
screaming essence of greed|절규하는 탐욕의 에센스
shrieking essence of torment|악을 쓰는 고뇌의 에센스
screaming essence of zeal|절규하는 열의의 에센스
screaming essence of wrath|절규하는 진노의 에센스
wailing essence of anguish|울부짖는 비통의 에센스
deafening essence of sorrow|귀를 찢는 슬픔의 에센스
shrieking essence of suffering|악을 쓰는 고통의 에센스
weeping essence of sorrow|흐느끼는 슬픔의 에센스
muttering essence of contempt|불평하는 경멸의 에센스
weeping essence of doubt|흐느끼는 의심의 에센스
screaming essence of sorrow|절규하는 슬픔의 에센스
shrieking essence of contempt|악을 쓰는 경멸의 에센스
deafening essence of misery|귀를 찢는 비참의 에센스
deafening essence of loathing|귀를 찢는 혐오의 에센스
weeping essence of contempt|흐느끼는 경멸의 에센스
screaming essence of woe|절규하는 비애의 에센스
screaming essence of hatred|절규하는 증오의 에센스
screaming essence of dread|절규하는 불안의 에센스
weeping essence of torment|흐느끼는 고뇌의 에센스
deafening essence of spite|귀를 찢는 악의의 에센스
deafening essence of wrath|귀를 찢는 진노의 에센스
screaming essence of anguish|절규하는 비통의 에센스
wailing essence of rage|울부짖는 격노의 에센스
screaming essence of suffering|절규하는 고통의 에센스
deafening essence of anger|귀를 찢는 분노의 에센스
essence of hysteria|발작의 에센스
shrieking essence of sorrow|악을 쓰는 슬픔의 에센스
deafening essence of greed|귀를 찢는 탐욕의 에센스
deafening essence of suffering|귀를 찢는 고통의 에센스
deafening essence of rage|귀를 찢는 격노의 에센스
shrieking essence of hatred|악을 쓰는 증오의 에센스
screaming essence of torment|절규하는 고뇌의 에센스
shrieking essence of anger|악을 쓰는 분노의 에센스
wailing essence of doubt|울부짖는 의심의 에센스
screaming essence of doubt|절규하는 의심의 에센스
shrieking essence of dread|악을 쓰는 불안의 에센스
wailing essence of torment|울부짖는 고뇌의 에센스
wailing essence of hatred|울부짖는 증오의 에센스
wailing essence of sorrow|울부짖는 슬픔의 에센스
whispering essence of hatred|속삭이는 증오의 에센스
muttering essence of anger|불평하는 분노의 에센스
weeping essence of rage|흐느끼는 격노의 에센스
deafening essence of envy|귀를 찢는 선망의 에센스
shrieking essence of zeal|악을 쓰는 열의의 에센스
deafening essence of dread|귀를 찢는 불안의 에센스
shrieking essence of wrath|악을 쓰는 진노의 에센스
deafening essence of fear|귀를 찢는 두려움의 에센스
deafening essence of anguish|귀를 찢는 비통의 에센스
screaming essence of anger|절규하는 분노의 에센스
shrieking essence of envy|악을 쓰는 선망의 에센스
muttering essence of hatred|불평하는 증오의 에센스
shrieking essence of spite|악을 쓰는 악의의 에센스
deafening essence of woe|귀를 찢는 비애의 에센스
shrieking essence of fear|악을 쓰는 두려움의 에센스
wailing essence of loathing|울부짖는 혐오의 에센스
wailing essence of spite|울부짖는 악의의 에센스
whispering essence of woe|속삭이는 비애의 에센스
wailing essence of anger|울부짖는 분노의 에센스
weeping essence of fear|흐느끼는 두려움의 에센스
screaming essence of spite|절규하는 악의의 에센스
screaming essence of misery|절규하는 비참의 에센스
essence of delirium|섬망의 에센스
wailing essence of contempt|울부짖는 경멸의 에센스
deafening essence of doubt|귀를 찢는 의심의 에센스
deafening essence of torment|귀를 찢는 고뇌의 에센스
whispering essence of greed|속삭이는 탐욕의 에센스
screaming essence of loathing|절규하는 혐오의 에센스
screaming essence of envy|절규하는 선망의 에센스
shrieking essence of rage|악을 쓰는 격노의 에센스
muttering essence of sorrow|불평하는 슬픔의 에센스
screaming essence of fear|절규하는 두려움의 에센스
shrieking essence of misery|악을 쓰는 비참의 에센스
shrieking essence of doubt|악을 쓰는 의심의 에센스
weeping essence of hatred|흐느끼는 증오의 에센스
weeping essence of greed|흐느끼는 탐욕의 에센스
remnant of corruption|타락의 유물
deafening essence of hatred|귀를 찢는 증오의 에센스
essence of horror|경악의 에센스
muttering essence of fear|불평하는 두려움의 에센스
screaming essence of rage|절규하는 격노의 에센스
wailing essence of fear|울부짖는 두려움의 에센스
deafening essence of scorn|귀를 찢는 멸시의 에센스
muttering essence of greed|불평하는 탐욕의 에센스
screaming essence of contempt|절규하는 경멸의 에센스
wailing essence of suffering|울부짖는 고통의 에센스
whispering essence of contempt|속삭이는 경멸의 에센스
wailing essence of woe|울부짖는 비애의 에센스
muttering essence of torment|불평하는 고뇌의 에센스
weeping essence of woe|흐느끼는 비애의 에센스
shrieking essence of woe|악을 쓰는 비애의 에센스
weeping essence of suffering|흐느끼는 고통의 에센스
essence of insanity|광기의 에센스
muttering essence of woe|불평하는 비애의 에센스
weeping essence of wrath|흐느끼는 진노의 에센스
weeping essence of anger|흐느끼는 분노의 에센스
shrieking essence of scorn|악을 쓰는 멸시의 에센스
black mórrigan|검은 모리건
fenumal queen|페누무스 여왕
nadia the soothing|위로하는 나디아
the dweller of the deep|심연의 주인
craicic chimeral|크라칸의 키메랄
saqawine retch|사카왈 레치
farric lynx alpha|페룰 스라소니 우두머리
primal crushclaw|원시 박살발톱
farric goliath|페룰의 골리앗
the great white bones|거대한 백색 뼈
wild hellion alpha|야생 헬리온 우두머리
craicic sand spitter|크라칸의 모래 전갈
farric taurus|페룰 황소자리
the conqueror wurm|정복자 웜
craicic squid|크라칸의 오징어
black death|어둠의 사신
saqawine rhex|사카왈 렉스
farric goatman|페룰 염소인간
farrul, first of the plains|평야의 최초, 페룰
paradisae venenum|극락조의 독
farric gargantuan|페룰 가르강튀아
farric ursa|페룰 곰
fenumal scorpion|페누무스 전갈
thistlesage|엉겅퀴세이지
saqawine cobra|사카왈 코브라
craicic savage crab|크라칸의 사나운 게
craicic watcher|크라칸의 감시자
primal cystcaller|원시 낭종소환사
fenumal scrabbler|페누무스 넝마주이
amarissa, daughter of merveil|머베일의 딸 아마릿사
craicic maw|크라칸의 큰턱개구리
boulderback|바위등
steelchaw|강철우걱
saqawine vulture|사카왈 시체매
farric magma hound|페룰 마그마 사냥개
wild bristle matron|야생 털짐승 어미
farric wolf alpha|페룰의 늑대 우두머리
vivid vulture|혈기 시체매
the hundred foot shadow|백 걸음의 그림자
vivid abberarach|혈기 애버라라크
fenumal devourer|페누무스 포식자
farric flame hellion alpha|페룰 화염 헬리온 우두머리
saqawine rhoa|사카왈 로아
the great white beast|거대한 백색 야수
fenumal widow|페누무스 과부 거미
wild brambleback|야생 가시나무등
tunnelworm|터널벌레
craicic shield crab|크라칸의 방패게
craiceann, first of the deep|심해의 최초, 크라칸
saqawal, first of the sky|하늘의 최초, 사카왈
the basilisk|바실리스크
brinecrack|염수균열
yellow beast|노란 야수
raihara, tukohama's loyal|투코하마의 충견 라이하라
ungulath|운굴라스
q'uru|쿠루
hollowskull, the willing host|자발적 숙주 텅빈해골
vivid watcher|혈기 감시자
saqawine blood viper|사카왈 피 독사
eyepecker|눈부리
craicic spider crab|크라칸의 거미게
the faun|판
the burning menace|불타는 존재
farric tiger alpha|페룰 호랑이 우두머리
primal rhex matriarch|원시 렉스 어미
farric ape|페룰 유인원
aidan the frenzied|격분한 에이단
oozeback bloom|등진물 무쇠부리
farric pit hound|페룰 구덩이 사냥개
fenumal hybrid arachnid|페누무스 잡종 거미류
fenumus, first of the night|밤의 최초, 페누무스
craicic vassal|크라칸의 봉신
farric frost hellion alpha|페룰 서리 헬리온 우두머리
brood princess|영충 공주
ambrosia, daughter of merveil|머베일의 딸 암브로시아
the weaver|직공
saqawine chimeral|사카왈 키메랄
farric chieftain|페룰 부족장
fenumal plagued arachnid|페누무스 역병 걸린 거미류
deadly joy|치명적인 기쁨
the journalist|집필가
the chosen|선택받은 자
hubris|오만
boon of justice|정의의 은혜
the journey|여행
the brawny battle mage|건장한 전투 마법사
the betrayal|배신
dying light|죽어가는 빛
the academic|학구열
assassin's favour|암살자의 호의
the eye of the dragon|용의 눈
eternal bonds|영원한 유대
the darkest dream|암울한 꿈
house of mirrors|거울의 집
azure rage|담청색 격노
nook's crown|누크의 왕관
auspicious ambitions|상서로운 야망
the cheater|사기꾼
the dreamland|꿈의 세계
the risk|위험
the last one standing|최후의 승자
echoes of love|사랑의 메아리
the fox in the brambles|가시나무에 얽힌 여우
the dungeon master|던전의 주인
gift of asenath|아세나스의 선물
the cataclysm|대재앙
the breach|균열
immortal resolve|불멸의 결의
merciless armament|무자비한 병기
struck by lightning|번개에 맞다
the valley of steel boxes|강철 상자의 계곡
the blazing fire|맹렬한 화염
the prince of darkness|어둠의 대공
the drunken aristocrat|만취한 귀족
the tireless extractor|끈기 있는 추출자
the thaumaturgist|마석학자
vanity|자만심
the gulf|만
dying anguish|죽음의 비통함
the poet|시인
terrible secret of space|우주의 끔찍한 비밀
baited expectations|현혹된 기대
misery in darkness|어둠 속 비참함
the arena champion|투기장의 용사
prometheus' armoury|프로메테우스의 무기고
call to the first ones|최초의 존재들에게 외치다
arrogance of the vaal|바알의 오만
the progeny of lunaris|루나리스의 자손
gift of the gemling queen|마석 여왕의 선물
disdain|경멸
unchained|해방
the traitor|배반자
coveted possession|갈망하던 소유
the deceiver|기만자
the destination|목적지
the ruthless ceinture|무정한 허리띠
the web|거미줄
blessing of god|신의 축복
the rabbit's foot|토끼 발
the dragon|용
a chilling wind|싸늘한 바람
love through ice|얼음을 가르는 사랑
the cache|은닉처
the innocent|결백한 자
the lord in black|어둠 속의 군주
the surgeon|외과의사
brush, paint and palette|붓, 물감과 팔레트
the obscured|가려진 자
the vast|광대함
the beast|짐승
the wolf|늑대
cartographer's delight|지도제작자의 기쁨
destined to crumble|무너질 운명
a fate worse than death|죽음보다 더한 운명
the metalsmith's gift|금속 세공사의 선물
the insane cat|실성한 고양이
the golden era|황금시대
cameria's cut|카메리아의 상처
left to fate|운명에 맡기다
fire of unknown origin|근원을 알 수 없는 화염
the calling|소명
prosperity|번영
turn the other cheek|다른 뺨을 내밀라
rats|쥐
the scholar|학자
scholar of the seas|바다의 학자
atziri's arsenal|앗지리의 병기창
the flora's gift|식물의 선물
sambodhi's wisdom|삼보디의 지혜
mitts|미트
the lich|리치
the wretched|불운아
home|고향
something dark|어두운 것
rain of chaos|카오스의 비
the jeweller's boon|보석 상인의 은혜
the eye of terror|공포의 눈
the opulent|호화로움
underground forest|지하 숲
parasitic passengers|기생충 밥벌레
the avenger|복수자
harmony of souls|영혼의 조화
the wolf's legacy|늑대의 유산
the brittle emperor|말라붙은 황제
peaceful moments|평화로운 순간들
a sea of blue|푸른색의 바다
the forsaken|버림받은 자
the celestial justicar|천공의 심판관
emperor's luck|황제의 행운
the gambler|도박꾼
the fletcher|화살 제조자
void of the elements|원소의 공허
the gladiator|검투사
the demoness|여악마
the card sharp|카드 사기꾼
the coming storm|다가오는 태풍
hunter's reward|사냥꾼의 보상
boundless realms|무한한 영역
the sephirot|세피로트
magnum opus|필생의 걸작
brother's stash|형제의 보관함
the apothecary|약제사
her mask|그녀의 가면
imperfect memories|불완전한 기억
eldritch perfection|섬뜩한 완벽
pride of the first ones|최초의 존재들의 자부심
father's love|아버지의 사랑
the one that got away|도망친 자
loyalty|충성심
the world eater|세계를 먹는 자
audacity|대담성
guardian's challenge|수호자의 시련
the scarred meadow|상처 입은 초원
the hive of knowledge|지식의 산실
soul quenched|갈증을 푼 영혼
the oath|서약
boon of the first ones|최초의 존재들의 은혜
the penitent|참회자
glimmer of hope|희망의 빛
the army of blood|피의 군대
the demon|악마
akil's prophecy|아킬의 예언
the artist|예술가
the heroic shot|영웅적인 시도
the damned|저주받은 자
the price of loyalty|충성의 대가
man with bear|사람과 곰
the deep ones|심해의 존재
the unexpected prize|뜻밖의 포상
the polymath|박식가
prejudice|편견
the visionary|공상가
heterochromia|이색증
the spoiled prince|버릇 없이 자란 왕자
the seeker|탐색자
the catalyst|기폭제
remembrance|추모
the escape|탈주
dark temptation|어둠의 유혹
the explorer|탐험가
the skeleton|해골
the wolf's shadow|늑대의 그림자
the lion|사자
i see brothers|형제가 보인다
the aesthete|탐미주의자
the devastator|파괴자
monochrome|단색화
the garish power|화려한 힘
the offering|공물
the wind|바람
the aspirant|지망자
justified ambition|정당한 야망
the sun|태양
three voices|3개의 목소리
vile power|사악한 힘
shard of fate|운명의 파편
the samurai's eye|사무라이의 눈
the greatest intentions|위대한 뜻
the magma crab|마그마 게
brotherhood in exile|유배의 형제
a mother's parting gift|어머니의 이별 선물
the wrath|진노
the messenger|전달자
the doppelganger|분신
gemcutter's mercy|세공사의 자비
wealth and power|부와 권력
bowyer's dream|활장이의 꿈
duality|이중성
the lord of celebration|축제의 군주
grave knowledge|무덤의 지식
silence and frost|침묵과 서리
the formless sea|무형의 바다
no traces|흔적 없음
haunting shadows|출몰하는 그림자
the wilted rose|시들은 장미
toxic tidings|유독한 소식
lethean temptation|레테의 유혹
the blessing of moosh|무쉬의 축복
from bone to ashes|뼈에서 재로
more is never enough|끝없는 욕심
the king's heart|왕의 심장
cursed words|저주의 말
the easy stroll|편안한 산책
ever-changing|변화무쌍
the side quest|부가 임무
the catch|월척
the mayor|시장
a stone perfected|완벽해진 돌
the valkyrie|발키리
succor of the sinless|결백한 자의 원조
the wolverine|오소리
thirst for knowledge|불타는 지식욕
the sigil|부적
the eldritch decay|섬뜩한 부패
dementophobia|실성 공포증
the sustenance|자양분
the fox|여우
the forgotten treasure|잊혀진 보물
the cartographer|지도제작자
the mad king|미치광이 왕
the forward gaze|전면 응시
endless night|끝없는 밤
the spark and the flame|불꽃과 화염
the trial|시험
three faces in the dark|어둠 속의 세 얼굴
broken truce|깨진 휴전
the finishing touch|화룡점정
thunderous skies|천둥 치는 하늘
rebirth|부활
the battle born|타고난 전투원
the tower|탑
vinia's token|비니아의 증표
lucky connections|행운의 연결
forbidden power|금지된 힘
beauty through death|죽음을 지나온 아름다움
the last supper|최후의 만찬
further invention|추가 발명
abandoned wealth|버려진 재산
the primordial|태고
the puzzle|수수께끼
rebirth and renewal|부활과 새로운 시작
the long con|기나긴 속임수
the endless darkness|끝없는 어둠
the scout|정찰병
the enthusiasts|열광자들
a note in the wind|바람 속의 기록
luminous trove|빛나는 발견물
draped in dreams|드리운 꿈
the queen|여왕
the watcher|감시자
assassin's gift|암살자의 선물
the dragon's heart|용의 심장
time-lost relic|오래된 유물
deathly designs|치명적인 설계
rain tempter|비 유혹자
poisoned faith|독을 품은 믿음
the cacophony|불협화음
dialla's subjugation|디알라의 예속
bijoux|보석
unrequited love|짝사랑
the survivalist|생존주의자
the surveyor|측량사
the bones|뼈
gemcutter's promise|세공사의 약속
a modest request|소박한 부탁
the undisputed|모두가 인정하는 자
the hook|갈고리
anarchy's price|혼란의 가치
the shepherd's sandals|양치기의 샌들
the road to power|힘에 이르는 길
etched in blood|아로새겨진 피
the patient|환자
the transformation|변화
the mercenary|용병
the price of prescience|선지의 대가
winter's embrace|겨울의 포옹
friendship|우정
the leviathan|레비아탄
the siren|사이렌
the pack leader|무리의 우두머리
the hale heart|건강한 심장
the dark mage|어둠 마법사
the warlord|전쟁군주
the one with all|만인과 함께하는 자
the immortal|불멸자
the twilight moon|황혼의 달
chaotic disposition|혼돈의 결정
alivia's grace|알리비아의 은총
the professor|교수
blind venture|무모한 모험
the twins|쌍둥이
the shieldbearer|방패 운반자
the rusted bard|녹슨 음유시인
the king's blade|왕의 검
the awakened|깨어난 자
matryoshka|마트료시카
the nurse|간호사
the realm|영역
the fortunate|행운아
emperor of purity|정화의 황제
choking guilt|숨막히는 죄책감
the lover|연인
the fathomless depths|깊이 모를 심연
the ethereal|천상에 속한 자
the lunaris priestess|루나리스 여사제
luck of the vaal|바알의 행운
the union|결합
divine justice|신성한 정의
the wolven king's bite|늑대왕의 이빨
sambodhi's vow|삼보디의 맹세
the encroaching darkness|잠식해오는 어둠
fateful meeting|운명적인 만남
costly curio|값비싼 예술품
the fool|어리석은 자
a dusty memory|먼지 쌓인 기억
the summoner|소환자
the deal|거래
the mind's eyes|마음의 눈
birth of the three|세 여신의 탄생
triskaidekaphobia|13 공포증
hunter's resolve|사냥꾼의 결의
the saint's treasure|성자의 보물
the rite of elements|원소의 의식
the feast|연회
the hunger|굶주림
a familiar call|귀에 익은 외침
demigod's wager|반신의 내기
burning blood|불타는 피
the rabid rhoa|광포한 로아
broken promises|깨진 약속
the admirer|숭배자
astral protection|우주의 보호
temperance|자제
the warden|간수
the tinkerer's table|땜장이의 작업대
the inoculated|접종자
humility|겸손
the eternal war|영원한 전쟁
light and truth|빛과 진실
the craving|갈망
the white knight|백기사
mawr blaidd|모어 블레이드
society's remorse|사회의 회한
the harvester|수확자
the adventuring spirit|모험 정신
the standoff|교착 상태
the enlightened|계몽된 자
the conduit|도관
lonely warrior|외로운 전사
lost worlds|잃어버린 세계
divine beauty|신성한 아름다움
the enforcer|집행자
the tyrant|폭군
last hope|최후의 희망
pride before the fall|몰락 직전의 긍지
hope|희망
the cursed king|저주받은 왕
keeper's corruption|보관자의 타락
acclimatisation|순응
tranquillity|평온
the master artisan|장인
the fiend|마귀
earth drinker|대지 흡수자
the whiteout|백시
judging voices|판단하는 목소리
treasure hunter|보물 사냥꾼
the throne|왕좌
desperate crusade|필사적인 성전
the inventor|발명가
the gentleman|신사
the wedding gift|결혼 선물
the landing|상륙
dark dreams|암흑의 꿈
the soul|영혼
the life thief|생명력 도둑
alluring bounty|유혹의 하사품
the hermit|은둔자
lachrymal necrosis|눈물샘의 괴사
the celestial stone|천공의 돌
lantador's lost love|란타도어의 죽은 연인
the pact|계약
lysah's respite|라이사의 휴식
desecrated virtue|훼손된 미덕
volatile power|불안한 권력
the mountain|산
the archmage's right hand|대마법사의 심복
the jester|어릿광대
squandered prosperity|허비된 번영
ambitious obsession|야심찬 집착
who asked|누가 물었느냐
the bear woman|웅녀
the long watch|오랜 감시
the offspring|자손
the emptiness|허무
doedre's madness|도이드리의 광기
the scavenger|시체 청소부
the sacrifice|희생
the old man|노인
the bargain|협상
imperial legacy|제국의 유산
the undaunted|의연한 자
the doctor|의사
the price of devotion|헌신의 대가
the fishmonger|생선 장수
council of cats|고양이 의회
reckless ambition|무모한 야망
the witch|마녀
seven years bad luck|7년 간의 불운
doryani's epiphany|도리아니의 통찰
the hoarder|비축가
the price of protection|보호의 대가
lingering remnants|지속되는 유물
the tumbleweed|회전초
the stormcaller|폭풍 소환사
checkmate|체크메이트
the porcupine|호저
the dapper prodigy|말쑥한 영재
death|죽음
might is right|힘이 정의다
the insatiable|만족을 모르는 자
brother's gift|형제의 선물
avian pursuit|새의 추적
the master|대가
a dab of ink|약간의 잉크
the endurance|인내
the chains that bind|속박의 사슬
the dreamer|몽상가
darker half|어두운 이면
the sword king's salute|검의 제왕의 경례
the strategist|전략가
chasing risk|위험을 좇아서
lucky deck|행운의 카드 묶음
the shortcut|지름길
the return of the rat|쥐의 귀환
alone in the darkness|어둠 속에서 홀로
the bitter blossom|쓰라린 만개
the astromancer|점성술사
the void|공허
buried treasure|파묻힌 보물
the body|몸통
altered perception|변질된 감각
the carrion crow|까마귀
the incantation|주문
the gemcutter|세공사
jack in the box|깜짝 상자
azyran's reward|아지란의 보상
perfection|완벽
mausoleum map (tier 11)|능묘 지도 (등급 11)
spider lair map (tier 9)|거미 소굴 지도 (등급 9)
mausoleum map (tier 15)|능묘 지도 (등급 15)
forbidden woods map (tier 10)|금단의 숲 지도 (등급 10)
maze of the minotaur map (tier 16)|미노타우로스의 미로 지도 (등급 16)
racecourse map (tier 14)|경주장 지도 (등급 14)
toxic sewer map (tier 12)|맹독성 하수도 지도 (등급 12)
cursed crypt map (tier 10)|저주받은 지하실 지도 (등급 10)
tropical island map (tier 9)|열대 섬 지도 (등급 9)
racecourse map (tier 16)|경주장 지도 (등급 16)
racecourse map (tier 10)|경주장 지도 (등급 10)
toxic sewer map (tier 16)|맹독성 하수도 지도 (등급 16)
tropical island map (tier 5)|열대 섬 지도 (등급 5)
silo map (tier 16)|곡물 창고 지도 (등급 16)
belfry map (tier 9)|종탑 지도 (등급 9)
silo map (tier 15)|곡물 창고 지도 (등급 15)
dunes map (tier 9)|사구 지도 (등급 9)
tropical island map (tier 2)|열대 섬 지도 (등급 2)
ziggurat map (tier 17)|지구라트 지도 (등급 17)
silo map (tier 11)|곡물 창고 지도 (등급 11)
belfry map (tier 6)|종탑 지도 (등급 6)
marshes map (tier 3)|습지 지도 (등급 3)
infested valley map (tier 15)|감염된 계곡 지도 (등급 15)
infested valley map (tier 16)|감염된 계곡 지도 (등급 16)
ramparts map (tier 15)|성벽 지도 (등급 15)
courthouse map (tier 16)|법원 지도 (등급 16)
dig map (tier 13)|발굴지 지도 (등급 13)
lookout map (tier 12)|전망대 지도 (등급 12)
dry sea map (tier 3)|메마른 바다 지도 (등급 3)
cursed crypt map (tier 16)|저주받은 지하실 지도 (등급 16)
courthouse map (tier 15)|법원 지도 (등급 15)
infested valley map (tier 12)|감염된 계곡 지도 (등급 12)
marshes map (tier 6)|습지 지도 (등급 6)
cursed crypt map (tier 14)|저주받은 지하실 지도 (등급 14)
courthouse map (tier 12)|법원 지도 (등급 12)
ramparts map (tier 16)|성벽 지도 (등급 16)
dig map (tier 16)|발굴지 지도 (등급 16)
crystal ore map (tier 16)|수정 광석 지도 (등급 16)
dry sea map (tier 6)|메마른 바다 지도 (등급 6)
leyline map (tier 16)|지맥 지도 (등급 16)
forge of the phoenix map (tier 16)|불사조의 대장간 지도 (등급 16)
bone crypt map (tier 16)|뼈 지하실 지도 (등급 16)
haunted mansion map (tier 9)|으스스한 대저택 지도 (등급 9)
ramparts map (tier 11)|성벽 지도 (등급 11)
leyline map (tier 13)|지맥 지도 (등급 13)
dig map (tier 10)|발굴지 지도 (등급 10)
leyline map (tier 10)|지맥 지도 (등급 10)
bone crypt map (tier 12)|뼈 지하실 지도 (등급 12)
colosseum map (tier 16)|원형 경기장 지도 (등급 16)
lava lake map (tier 16)|용암 호수 지도 (등급 16)
promenade map (tier 6)|산책로 지도 (등급 6)
lair of the hydra map (tier 16)|히드라의 소굴 지도 (등급 16)
spider forest map (tier 7)|거미 숲 지도 (등급 7)
promenade map (tier 9)|산책로 지도 (등급 9)
lava lake map (tier 13)|용암 호수 지도 (등급 13)
carcass map (tier 16)|시체 지도 (등급 16)
coves map (tier 16)|만 지도 (등급 16)
temple map (tier 16)|사원 지도 (등급 16)
coves map (tier 14)|만 지도 (등급 14)
carcass map (tier 13)|시체 지도 (등급 13)
temple map (tier 14)|사원 지도 (등급 14)
geode map (tier 15)|정동석 지도 (등급 15)
dark forest map (tier 9)|어둠의 숲 지도 (등급 9)
geode map (tier 12)|정동석 지도 (등급 12)
lighthouse map (tier 16)|등대 지도 (등급 16)
arachnid tomb map (tier 8)|거미류 무덤 지도 (등급 8)
coral ruins map (tier 9)|산호 유적 지도 (등급 9)
sepulchre map (tier 16)|매장소 지도 (등급 16)
geode map (tier 16)|정동석 지도 (등급 16)
dark forest map (tier 2)|어둠의 숲 지도 (등급 2)
dark forest map (tier 5)|어둠의 숲 지도 (등급 5)
maps (tier 1)|지도(1등급)
maps (tier 2)|지도(2등급)
maps (tier 3)|지도(3등급)
maps (tier 4)|지도(4등급)
maps (tier 5)|지도(5등급)
maps (tier 6)|지도(6등급)
maps (tier 7)|지도(7등급)
maps (tier 8)|지도(8등급)
maps (tier 9)|지도(9등급)
maps (tier 10)|지도(10등급)
maps (tier 11)|지도(11등급)
maps (tier 12)|지도(12등급)
maps (tier 13)|지도(13등급)
maps (tier 14)|지도(14등급)
maps (tier 15)|지도(15등급)
maps (tier 16)|지도(16등급)
maps (tier 17)|지도(17등급)
siege map (tier 8)|공성 지도 (등급 8)
summit map (tier 8)|꼭대기 지도 (등급 8)
port map (tier 11)|항만 지도 (등급 11)
dunes map (tier 2)|사구 지도 (등급 2)
dunes map (tier 5)|사구 지도 (등급 5)
marshes map (tier 14)|습지 지도 (등급 14)
siege map (tier 4)|공성 지도 (등급 4)
marshes map (tier 16)|습지 지도 (등급 16)
summit map (tier 5)|꼭대기 지도 (등급 5)
academy map (tier 16)|학술원 지도 (등급 16)
mausoleum map (tier 7)|능묘 지도 (등급 7)
siege map (tier 1)|공성 지도 (등급 1)
toxic sewer map (tier 9)|맹독성 하수도 지도 (등급 9)
academy map (tier 15)|학술원 지도 (등급 15)
mausoleum map (tier 4)|능묘 지도 (등급 4)
gardens map (tier 12)|정원 지도 (등급 12)
castle ruins map (tier 16)|성곽 유적 지도 (등급 16)
cells map (tier 15)|감방 지도 (등급 15)
museum map (tier 16)|박물관 지도 (등급 16)
crimson township map (tier 16)|진홍색 마을 지도 (등급 16)
cells map (tier 16)|감방 지도 (등급 16)
strand map (tier 16)|해안 지도 (등급 16)
gardens map (tier 16)|정원 지도 (등급 16)
crimson township map (tier 14)|진홍색 마을 지도 (등급 14)
cells map (tier 7)|감방 지도 (등급 7)
museum map (tier 12)|박물관 지도 (등급 12)
museum map (tier 15)|박물관 지도 (등급 15)
crimson township map (tier 11)|진홍색 마을 지도 (등급 11)
strand map (tier 10)|해안 지도 (등급 10)
marshes map (tier 10)|습지 지도 (등급 10)
forbidden woods map (tier 14)|금단의 숲 지도 (등급 14)
port map (tier 14)|항만 지도 (등급 14)
shore map (tier 13)|바닷가 지도 (등급 13)
cells map (tier 4)|감방 지도 (등급 4)
forbidden woods map (tier 16)|금단의 숲 지도 (등급 16)
strand map (tier 14)|해안 지도 (등급 14)
castle ruins map (tier 13)|성곽 유적 지도 (등급 13)
port map (tier 16)|항만 지도 (등급 16)
shore map (tier 16)|바닷가 지도 (등급 16)
mesa map (tier 7)|메사 지도 (등급 7)
cemetery map (tier 7)|공동묘지 지도 (등급 7)
desert spring map (tier 16)|사막의 샘 지도 (등급 16)
spider lair map (tier 16)|거미 소굴 지도 (등급 16)
mesa map (tier 4)|메사 지도 (등급 4)
desert spring map (tier 13)|사막의 샘 지도 (등급 13)
vaal pyramid map (tier 4)|바알 피라미드 지도 (등급 4)
terrace map (tier 16)|테라스 지도 (등급 16)
spider lair map (tier 12)|거미 소굴 지도 (등급 12)
cursed crypt map (tier 7)|저주받은 지하실 지도 (등급 7)
courtyard map (tier 5)|안뜰 지도 (등급 5)
glacier map (tier 16)|빙하 지도 (등급 16)
atoll map (tier 5)|산호섬 지도 (등급 5)
courtyard map (tier 8)|안뜰 지도 (등급 8)
sanctuary map (tier 17)|성역 지도 (등급 17)
terrace map (tier 15)|테라스 지도 (등급 15)
atoll map (tier 8)|산호섬 지도 (등급 8)
cemetery map (tier 4)|공동묘지 지도 (등급 4)
forbidden woods map (tier 7)|금단의 숲 지도 (등급 7)
vaal pyramid map (tier 7)|바알 피라미드 지도 (등급 7)
vault map (tier 16)|금고실 지도 (등급 16)
vault map (tier 15)|금고실 지도 (등급 15)
cold river map (tier 8)|차가운 강 지도 (등급 8)
cemetery map (tier 11)|공동묘지 지도 (등급 11)
vault map (tier 11)|금고실 지도 (등급 11)
citadel map (tier 17)|성채 지도 (등급 17)
cemetery map (tier 15)|공동묘지 지도 (등급 15)
jungle valley map (tier 8)|밀림 계곡 지도 (등급 8)
moon temple map (tier 4)|달의 사원 지도 (등급 4)
carcass map (tier 5)|시체 지도 (등급 5)
cemetery map (tier 16)|공동묘지 지도 (등급 16)
carcass map (tier 2)|시체 지도 (등급 2)
maze map (tier 16)|미로 지도 (등급 16)
city square map (tier 11)|도시 광장 지도 (등급 11)
carcass map (tier 9)|시체 지도 (등급 9)
grotto map (tier 11)|석굴 지도 (등급 11)
grotto map (tier 14)|석굴 지도 (등급 14)
glacier map (tier 13)|빙하 지도 (등급 13)
grotto map (tier 16)|석굴 지도 (등급 16)
city square map (tier 15)|도시 광장 지도 (등급 15)
maze map (tier 14)|미로 지도 (등급 14)
city square map (tier 16)|도시 광장 지도 (등급 16)
dry sea map (tier 10)|메마른 바다 지도 (등급 10)
dry sea map (tier 14)|메마른 바다 지도 (등급 14)
moon temple map (tier 7)|달의 사원 지도 (등급 7)
dry sea map (tier 16)|메마른 바다 지도 (등급 16)
graveyard map (tier 12)|묘지 지도 (등급 12)
plateau map (tier 16)|고원 지도 (등급 16)
flooded mine map (tier 13)|물에 잠긴 광산 지도 (등급 13)
flooded mine map (tier 16)|물에 잠긴 광산 지도 (등급 16)
plateau map (tier 12)|고원 지도 (등급 12)
channel map (tier 14)|물길 지도 (등급 14)
channel map (tier 16)|물길 지도 (등급 16)
lair map (tier 9)|소굴 지도 (등급 9)
fortress map (tier 17)|요새 지도 (등급 17)
lair map (tier 5)|소굴 지도 (등급 5)
vault map (tier 7)|금고실 지도 (등급 7)
channel map (tier 10)|물길 지도 (등급 10)
lair map (tier 2)|소굴 지도 (등급 2)
burial chambers map (tier 10)|묘실 지도 (등급 10)
scriptorium map (tier 12)|필사실 지도 (등급 12)
vault map (tier 4)|금고실 지도 (등급 4)
burial chambers map (tier 13)|묘실 지도 (등급 13)
graveyard map (tier 16)|묘지 지도 (등급 16)
scriptorium map (tier 16)|필사실 지도 (등급 16)
burial chambers map (tier 16)|묘실 지도 (등급 16)
foundry map (tier 11)|주조소 지도 (등급 11)
foundry map (tier 16)|주조소 지도 (등급 16)
colosseum map (tier 6)|원형 경기장 지도 (등급 6)
ancient city map (tier 5)|고대 도시 지도 (등급 5)
ancient city map (tier 8)|고대 도시 지도 (등급 8)
foundry map (tier 14)|주조소 지도 (등급 14)
colosseum map (tier 9)|원형 경기장 지도 (등급 9)
abomination map (tier 17)|흉물 지도 (등급 17)
tropical island map (tier 13)|열대 섬 지도 (등급 13)
basilica map (tier 9)|교회당 지도 (등급 9)
bog map (tier 3)|습지대 지도 (등급 3)
tropical island map (tier 16)|열대 섬 지도 (등급 16)
bog map (tier 6)|습지대 지도 (등급 6)
fields map (tier 16)|들판 지도 (등급 16)
fields map (tier 12)|들판 지도 (등급 12)
pit of the chimera map (tier 16)|키메라의 구덩이 지도 (등급 16)
underground sea map (tier 13)|지하 해양 지도 (등급 13)
underground sea map (tier 16)|지하 해양 지도 (등급 16)
haunted mansion map (tier 16)|으스스한 대저택 지도 (등급 16)
residence map (tier 14)|주택 지도 (등급 14)
arachnid tomb map (tier 11)|거미류 무덤 지도 (등급 11)
haunted mansion map (tier 12)|으스스한 대저택 지도 (등급 12)
arachnid tomb map (tier 16)|거미류 무덤 지도 (등급 16)
arachnid tomb map (tier 15)|거미류 무덤 지도 (등급 15)
sulphur vents map (tier 16)|유황 분출구 지도 (등급 16)
residence map (tier 16)|주택 지도 (등급 16)
defiled cathedral map (tier 9)|더럽혀진 대성당 지도 (등급 9)
dungeon map (tier 5)|던전 지도 (등급 5)
underground river map (tier 15)|지하 강 지도 (등급 15)
defiled cathedral map (tier 6)|더럽혀진 대성당 지도 (등급 6)
dungeon map (tier 2)|던전 지도 (등급 2)
vaal pyramid map (tier 15)|바알 피라미드 지도 (등급 15)
coral ruins map (tier 12)|산호 유적 지도 (등급 12)
vaal pyramid map (tier 16)|바알 피라미드 지도 (등급 16)
crater map (tier 16)|분화구 지도 (등급 16)
underground river map (tier 16)|지하 강 지도 (등급 16)
malformation map (tier 13)|기형 지도 (등급 13)
malformation map (tier 16)|기형 지도 (등급 16)
dungeon map (tier 9)|던전 지도 (등급 9)
malformation map (tier 10)|기형 지도 (등급 10)
vaal pyramid map (tier 11)|바알 피라미드 지도 (등급 11)
underground sea map (tier 10)|지하 해양 지도 (등급 10)
scriptorium map (tier 4)|필사실 지도 (등급 4)
fungal hollow map (tier 10)|곰팡이 동혈 지도 (등급 10)
scriptorium map (tier 1)|필사실 지도 (등급 1)
bone crypt map (tier 4)|뼈 지하실 지도 (등급 4)
fungal hollow map (tier 14)|곰팡이 동혈 지도 (등급 14)
chateau map (tier 7)|대저택 지도 (등급 7)
overgrown shrine map (tier 6)|무성한 성소 지도 (등급 6)
fungal hollow map (tier 16)|곰팡이 동혈 지도 (등급 16)
coral ruins map (tier 16)|산호 유적 지도 (등급 16)
bone crypt map (tier 8)|뼈 지하실 지도 (등급 8)
scriptorium map (tier 8)|필사실 지도 (등급 8)
mesa map (tier 16)|메사 지도 (등급 16)
sulphur vents map (tier 10)|유황 분출구 지도 (등급 10)
sulphur vents map (tier 13)|유황 분출구 지도 (등급 13)
mesa map (tier 11)|메사 지도 (등급 11)
mesa map (tier 15)|메사 지도 (등급 15)
arcade map (tier 13)|상점가 지도 (등급 13)
arcade map (tier 16)|상점가 지도 (등급 16)
siege map (tier 12)|공성 지도 (등급 12)
gardens map (tier 1)|정원 지도 (등급 1)
siege map (tier 16)|공성 지도 (등급 16)
gardens map (tier 4)|정원 지도 (등급 4)
relic chambers map (tier 11)|유물의 방 지도 (등급 11)
desert map (tier 8)|사막 지도 (등급 8)
gardens map (tier 8)|정원 지도 (등급 8)
defiled cathedral map (tier 16)|더럽혀진 대성당 지도 (등급 16)
plateau map (tier 8)|고원 지도 (등급 8)
overgrown shrine map (tier 3)|무성한 성소 지도 (등급 3)
bone crypt map (tier 1)|뼈 지하실 지도 (등급 1)
cage map (tier 10)|창살 지도 (등급 10)
cage map (tier 14)|창살 지도 (등급 14)
defiled cathedral map (tier 13)|더럽혀진 대성당 지도 (등급 13)
cage map (tier 16)|창살 지도 (등급 16)
spider forest map (tier 16)|거미 숲 지도 (등급 16)
colonnade map (tier 8)|가로수 지도 (등급 8)
spider forest map (tier 14)|거미 숲 지도 (등급 14)
ramparts map (tier 8)|성벽 지도 (등급 8)
lava lake map (tier 9)|용암 호수 지도 (등급 9)
alleyways map (tier 16)|골목길 지도 (등급 16)
spider forest map (tier 10)|거미 숲 지도 (등급 10)
alleyways map (tier 15)|골목길 지도 (등급 15)
relic chambers map (tier 4)|유물의 방 지도 (등급 4)
relic chambers map (tier 7)|유물의 방 지도 (등급 7)
orchard map (tier 16)|과수원 지도 (등급 16)
crater map (tier 11)|분화구 지도 (등급 11)
colonnade map (tier 5)|가로수 지도 (등급 5)
crater map (tier 14)|분화구 지도 (등급 14)
shore map (tier 9)|바닷가 지도 (등급 9)
estuary map (tier 9)|강어귀 지도 (등급 9)
estuary map (tier 6)|강어귀 지도 (등급 6)
pier map (tier 11)|선창 지도 (등급 11)
bramble valley map (tier 10)|가시나무 계곡 지도 (등급 10)
flooded mine map (tier 9)|물에 잠긴 광산 지도 (등급 9)
shore map (tier 6)|바닷가 지도 (등급 6)
bramble valley map (tier 16)|가시나무 계곡 지도 (등급 16)
relic chambers map (tier 15)|유물의 방 지도 (등급 15)
pier map (tier 14)|선창 지도 (등급 14)
relic chambers map (tier 16)|유물의 방 지도 (등급 16)
bramble valley map (tier 14)|가시나무 계곡 지도 (등급 14)
pier map (tier 16)|선창 지도 (등급 16)
estuary map (tier 13)|강어귀 지도 (등급 13)
flooded mine map (tier 2)|물에 잠긴 광산 지도 (등급 2)
lava lake map (tier 5)|용암 호수 지도 (등급 5)
estuary map (tier 16)|강어귀 지도 (등급 16)
lava lake map (tier 2)|용암 호수 지도 (등급 2)
vaal temple map (tier 16)|바알 사원 지도 (등급 16)
flooded mine map (tier 5)|물에 잠긴 광산 지도 (등급 5)
belfry map (tier 13)|종탑 지도 (등급 13)
graveyard map (tier 8)|묘지 지도 (등급 8)
cells map (tier 11)|감방 지도 (등급 11)
belfry map (tier 16)|종탑 지도 (등급 16)
necropolis map (tier 12)|매장지 지도 (등급 12)
graveyard map (tier 5)|묘지 지도 (등급 5)
necropolis map (tier 15)|매장지 지도 (등급 15)
caldera map (tier 16)|칼데라 지도 (등급 16)
caldera map (tier 13)|칼데라 지도 (등급 13)
channel map (tier 7)|물길 지도 (등급 7)
bramble valley map (tier 7)|가시나무 계곡 지도 (등급 7)
summit map (tier 12)|꼭대기 지도 (등급 12)
summit map (tier 16)|꼭대기 지도 (등급 16)
jungle valley map (tier 11)|밀림 계곡 지도 (등급 11)
jungle valley map (tier 16)|밀림 계곡 지도 (등급 16)
jungle valley map (tier 15)|밀림 계곡 지도 (등급 15)
lair map (tier 16)|소굴 지도 (등급 16)
courtyard map (tier 16)|안뜰 지도 (등급 16)
ashen wood map (tier 16)|잿빛 숲 지도 (등급 16)
courtyard map (tier 12)|안뜰 지도 (등급 12)
plateau map (tier 5)|고원 지도 (등급 5)
ashen wood map (tier 13)|잿빛 숲 지도 (등급 13)
palace map (tier 16)|궁전 지도 (등급 16)
desert map (tier 11)|사막 지도 (등급 11)
cage map (tier 6)|창살 지도 (등급 6)
silo map (tier 8)|곡물 창고 지도 (등급 8)
desert map (tier 15)|사막 지도 (등급 15)
desert map (tier 16)|사막 지도 (등급 16)
cage map (tier 3)|창살 지도 (등급 3)
lair map (tier 13)|소굴 지도 (등급 13)
cold river map (tier 16)|차가운 강 지도 (등급 16)
palace map (tier 9)|궁전 지도 (등급 9)
cold river map (tier 15)|차가운 강 지도 (등급 15)
palace map (tier 12)|궁전 지도 (등급 12)
cold river map (tier 11)|차가운 강 지도 (등급 11)
pit map (tier 15)|구덩이 지도 (등급 15)
pit map (tier 16)|구덩이 지도 (등급 16)
dark forest map (tier 16)|어둠의 숲 지도 (등급 16)
basilica map (tier 16)|교회당 지도 (등급 16)
armoury map (tier 6)|갑주 창고 지도 (등급 6)
fields map (tier 5)|들판 지도 (등급 5)
colosseum map (tier 13)|원형 경기장 지도 (등급 13)
racecourse map (tier 7)|경주장 지도 (등급 7)
dark forest map (tier 13)|어둠의 숲 지도 (등급 13)
dungeon map (tier 16)|던전 지도 (등급 16)
colonnade map (tier 16)|가로수 지도 (등급 16)
dungeon map (tier 13)|던전 지도 (등급 13)
colonnade map (tier 12)|가로수 지도 (등급 12)
lookout map (tier 16)|전망대 지도 (등급 16)
moon temple map (tier 15)|달의 사원 지도 (등급 15)
fungal hollow map (tier 6)|곰팡이 동혈 지도 (등급 6)
moon temple map (tier 16)|달의 사원 지도 (등급 16)
lookout map (tier 15)|전망대 지도 (등급 15)
castle ruins map (tier 6)|성곽 유적 지도 (등급 6)
moon temple map (tier 11)|달의 사원 지도 (등급 11)
castle ruins map (tier 9)|성곽 유적 지도 (등급 9)
fields map (tier 8)|들판 지도 (등급 8)
city square map (tier 8)|도시 광장 지도 (등급 8)
strand map (tier 6)|해안 지도 (등급 6)
chateau map (tier 14)|대저택 지도 (등급 14)
ancient city map (tier 12)|고대 도시 지도 (등급 12)
chateau map (tier 16)|대저택 지도 (등급 16)
strand map (tier 3)|해안 지도 (등급 3)
overgrown shrine map (tier 14)|무성한 성소 지도 (등급 14)
overgrown shrine map (tier 16)|무성한 성소 지도 (등급 16)
overgrown shrine map (tier 10)|무성한 성소 지도 (등급 10)
atoll map (tier 16)|산호섬 지도 (등급 16)
fungal hollow map (tier 3)|곰팡이 동혈 지도 (등급 3)
atoll map (tier 12)|산호섬 지도 (등급 12)
promenade map (tier 16)|산책로 지도 (등급 16)
necropolis map (tier 16)|매장지 지도 (등급 16)
armoury map (tier 14)|갑주 창고 지도 (등급 14)
bog map (tier 10)|습지대 지도 (등급 10)
armoury map (tier 16)|갑주 창고 지도 (등급 16)
promenade map (tier 13)|산책로 지도 (등급 13)
beach map (tier 16)|해변 지도 (등급 16)
mausoleum map (tier 16)|능묘 지도 (등급 16)
dunes map (tier 13)|사구 지도 (등급 13)
bog map (tier 16)|습지대 지도 (등급 16)
dunes map (tier 16)|사구 지도 (등급 16)
bog map (tier 14)|습지대 지도 (등급 14)
chateau map (tier 10)|대저택 지도 (등급 10)
armoury map (tier 10)|갑주 창고 지도 (등급 10)
ancient city map (tier 16)|고대 도시 지도 (등급 16)
beach map (tier 14)|해변 지도 (등급 14)
armoury map (tier 3)|갑주 창고 지도 (등급 3)
basilica map (tier 12)|교회당 지도 (등급 12)
veritania's citadel map|베리타니아의 시타델 지도
purifier-occupied map|정화자의 손에 넘어간 지도
enslaver-occupied map|조종자의 손에 넘어간 지도
al-hezmin's citadel map|알-헤즈민의 시타델 지도
constrictor-occupied map|위압자의 손에 넘어간 지도
drox's citadel map|드록스의 시타델 지도
eradicator-occupied map|박멸자의 손에 넘어간 지도
baran's citadel map|바란의 시타델 지도
blight-ravaged map (tier 16)|역병에 유린당한 지도 (등급 16)
blight-ravaged map (tier 15)|역병에 유린당한 지도 (등급 15)
blight-ravaged map (tier 14)|역병에 유린당한 지도 (등급 14)
blighted map (tier 10)|역병 걸린 지도 (등급 10)
blighted map (tier 5)|역병 걸린 지도 (등급 5)
blighted map (tier 4)|역병 걸린 지도 (등급 4)
blighted map (tier 16)|역병 걸린 지도 (등급 16)
blighted map (tier 7)|역병 걸린 지도 (등급 7)
blighted map (tier 15)|역병 걸린 지도 (등급 15)
blighted map (tier 6)|역병 걸린 지도 (등급 6)
blighted map (tier 14)|역병 걸린 지도 (등급 14)
blighted map (tier 1)|역병 걸린 지도 (등급 1)
blighted map (tier 13)|역병 걸린 지도 (등급 13)
blighted map (tier 12)|역병 걸린 지도 (등급 12)
blighted map (tier 3)|역병 걸린 지도 (등급 3)
blighted map (tier 11)|역병 걸린 지도 (등급 11)
blighted map (tier 2)|역병 걸린 지도 (등급 2)
blighted map (tier 9)|역병 걸린 지도 (등급 9)
blighted map (tier 8)|역병 걸린 지도 (등급 8)
the putrid cloister (tier 12)|악취 나는 수도원 (등급 12)
mao kun (tier 9)|마오 쿤 (등급 9)
the twilight temple (tier 16)|황혼의 사원 (등급 16)
the putrid cloister (tier 16)|악취 나는 수도원 (등급 16)
the twilight temple (tier 15)|황혼의 사원 (등급 15)
the putrid cloister (tier 15)|악취 나는 수도원 (등급 15)
mao kun (tier 6)|마오 쿤 (등급 6)
mao kun (tier 16)|마오 쿤 (등급 16)
replica pillars of arun (tier 16)|아룬의 기둥 모조품 (등급 16)
mao kun (tier 13)|마오 쿤 (등급 13)
replica pillars of arun (tier 13)|아룬의 기둥 모조품 (등급 13)
the vinktar square (tier 12)|빙타 광장 (등급 12)
hall of grandmasters (tier 6)|명인의 전당 (등급 6)
the twilight temple (tier 11)|황혼의 사원 (등급 11)
acton's nightmare (tier 6)|액턴의 악몽 (등급 6)
the vinktar square (tier 16)|빙타 광장 (등급 16)
acton's nightmare (tier 3)|액턴의 악몽 (등급 3)
hall of grandmasters (tier 9)|명인의 전당 (등급 9)
cortex (tier 11)|코텍스 (등급 11)
the twilight temple (tier 7)|황혼의 사원 (등급 7)
maelström of chaos (tier 5)|혼돈의 마엘스트롬 (등급 5)
the twilight temple (tier 4)|황혼의 사원 (등급 4)
maelström of chaos (tier 8)|혼돈의 마엘스트롬 (등급 8)
maelström of chaos (tier 12)|혼돈의 마엘스트롬 (등급 12)
the tower of ordeals (tier 16)|시련의 탑 (등급 16)
maelström of chaos (tier 16)|혼돈의 마엘스트롬 (등급 16)
infused beachhead (tier 11)|주입된 교두보 (등급 11)
olmec's sanctum (tier 12)|올멕의 지성소 (등급 12)
olmec's sanctum (tier 16)|올멕의 지성소 (등급 16)
doryani's machinarium (tier 16)|도리아니의 기계실 (등급 16)
pillars of arun (tier 2)|아룬의 기둥 (등급 2)
hall of grandmasters (tier 13)|명인의 전당 (등급 13)
doryani's machinarium (tier 14)|도리아니의 기계실 (등급 14)
pillars of arun (tier 5)|아룬의 기둥 (등급 5)
pillars of arun (tier 9)|아룬의 기둥 (등급 9)
vaults of atziri (tier 7)|앗지리의 금고실 (등급 7)
vaults of atziri (tier 4)|앗지리의 금고실 (등급 4)
the coward's trial (tier 7)|겁쟁이의 시험 (등급 7)
hall of grandmasters (tier 16)|명인의 전당 (등급 16)
olmec's sanctum (tier 8)|올멕의 지성소 (등급 8)
acton's nightmare (tier 10)|액턴의 악몽 (등급 10)
replica poorjoy's asylum (tier 14)|푸어조이의 은신처 모조품 (등급 14)
acton's nightmare (tier 16)|액턴의 악몽 (등급 16)
replica poorjoy's asylum (tier 16)|푸어조이의 은신처 모조품 (등급 16)
acton's nightmare (tier 14)|액턴의 악몽 (등급 14)
replica pillars of arun (tier 5)|아룬의 기둥 모조품 (등급 5)
pillars of arun (tier 13)|아룬의 기둥 (등급 13)
oba's cursed trove (tier 16)|오바의 저주받은 전리품 (등급 16)
pillars of arun (tier 16)|아룬의 기둥 (등급 16)
olmec's sanctum (tier 1)|올멕의 지성소 (등급 1)
replica pillars of arun (tier 9)|아룬의 기둥 모조품 (등급 9)
olmec's sanctum (tier 4)|올멕의 지성소 (등급 4)
oba's cursed trove (tier 10)|오바의 저주받은 전리품 (등급 10)
caer blaidd, wolfpack's den (tier 15)|캐어블레이드 늑대의 소굴 (등급 15)
whakawairua tuahu (tier 14)|와카와 투아후 (등급 14)
caer blaidd, wolfpack's den (tier 16)|캐어블레이드 늑대의 소굴 (등급 16)
replica pillars of arun (tier 2)|아룬의 기둥 모조품 (등급 2)
the beachhead (tier 5)|교두보 (등급 5)
whakawairua tuahu (tier 10)|와카와 투아후 (등급 10)
oba's cursed trove (tier 13)|오바의 저주받은 전리품 (등급 13)
death and taxes (tier 16)|죽음과 의무 (등급 16)
death and taxes (tier 15)|죽음과 의무 (등급 15)
replica cortex (tier 11)|코텍스 모조품 (등급 11)
whakawairua tuahu (tier 16)|와카와 투아후 (등급 16)
death and taxes (tier 12)|죽음과 의무 (등급 12)
unique synthesis maps|고유 결합 지도
whakawairua tuahu (tier 3)|와카와 투아후 (등급 3)
vaults of atziri (tier 11)|앗지리의 금고실 (등급 11)
twisted distant memory (tier 11)|뒤틀린 희미한 기억 (등급 11)
whakawairua tuahu (tier 6)|와카와 투아후 (등급 6)
the vinktar square (tier 8)|빙타 광장 (등급 8)
vaults of atziri (tier 15)|앗지리의 금고실 (등급 15)
vaults of atziri (tier 16)|앗지리의 금고실 (등급 16)
the beachhead (tier 15)|교두보 (등급 15)
poorjoy's asylum (tier 16)|푸어조이의 은신처 (등급 16)
the beachhead (tier 10)|교두보 (등급 10)
the vinktar square (tier 5)|빙타 광장 (등급 5)
poorjoy's asylum (tier 14)|푸어조이의 은신처 (등급 14)
hallowed ground (tier 4)|거룩한 대지 (등급 4)
the coward's trial (tier 10)|겁쟁이의 시험 (등급 10)
hallowed ground (tier 16)|거룩한 대지 (등급 16)
augmented distant memory (tier 11)|강화된 희미한 기억 (등급 11)
altered distant memory (tier 11)|뒤바뀐 희미한 기억 (등급 11)
hallowed ground (tier 15)|거룩한 대지 (등급 15)
hallowed ground (tier 11)|거룩한 대지 (등급 11)
hallowed ground (tier 7)|거룩한 대지 (등급 7)
rewritten distant memory (tier 11)|다시 쓰인 희미한 기억 (등급 11)
the coward's trial (tier 14)|겁쟁이의 시험 (등급 14)
the coward's trial (tier 16)|겁쟁이의 시험 (등급 16)
honoured tattoo of the makanga|마캉가의 명예로운 문신
honoured tattoo of the sky|하늘의 명예로운 문신
omen of bequeathal|대물림의 징조
honoured tattoo of the hunter|사냥꾼의 명예로운 문신
tattoo of the rongokurai makanga|롱고쿠라이 마캉가의 문신
honoured tattoo of the pillager|약탈꾼의 명예로운 문신
honoured tattoo of the barbarian|야만인의 명예로운 문신
honoured tattoo of the wise|현명한 자의 명예로운 문신
honoured tattoo of the hatungo|하툰고의 명예로운 문신
honoured tattoo of the turtle|거북이의 명예로운 문신
tattoo of the ngamahu makanga|나마후 마캉가의 문신
tattoo of the kitava makanga|키타바 마캉가의 문신
honoured tattoo of the mountain|산맥의 명예로운 문신
loyalty tattoo of rakiata|라키아타의 충성 문신
loyalty tattoo of maata|마아타의 충성 문신
ancestral tattoo of bloodlines|혈맹의 선조 문신
honoured tattoo of the pa|파의 명예로운 문신
loyalty tattoo of kahuturoa|카후투로아의 충성 문신
imperial delirium orb|제국 환영의 오브
honoured tattoo of the flood|홍수의 명예로운 문신
tattoo of the tawhoa makanga|타호아 마캉가의 문신
tattoo of the valako makanga|발라코 마캉가의 문신
honoured tattoo of the warlord|전쟁군주의 명예로운 문신
tattoo of the hinekora makanga|히네코라 마캉가의 문신
loyalty tattoo of ahuana|아후아나의 충성 문신
honoured tattoo of the tuatara|투아타라의 명예로운 문신
jewellery recombinator|장신구 재조합기
loyalty tattoo of kiloava|킬로아바의 충성 문신
armour recombinator|방어구 재조합기
omen of resurgence|재기의 징조
tattoo of the arohongui makanga|아로호누이 마캉가의 문신
loyalty tattoo of ikiaho|이키아호의 충성 문신
loyalty tattoo of akoya|아코야의 충성 문신
loyalty tattoo of kaom|카옴의 충성 문신
omen of revenge|복수의 징조
journey tattoo of makanui|마카누이의 여정 문신
omen of acceleration|가속의 징조
loyalty tattoo of utula|우툴라의 충성 문신
honoured tattoo of the storm|폭풍의 명예로운 문신
honoured tattoo of the flock|무리의 명예로운 문신
tattoo of the ramako makanga|라마코 마캉가의 문신
tattoo of the tasalio makanga|타살리오 마캉가의 문신
honoured tattoo of the oak|참나무의 명예로운 문신
honoured tattoo of the berserker|광전사의 명예로운 문신
tattoo of the tukohama makanga|투코하마 마캉가의 문신
weapon recombinator|무기 재조합기
loyalty tattoo of tawhanuku|타하누쿠의 충성 문신
honoured tattoo of the dove|비둘기의 명예로운 문신
